MapSize 24 24
StartPos 3 3
########################
#......................#
#......................#
#......................#
#......................#
#......................#
#......................#
#......................#
#......................#
#......##########......#
#......##########......#
#......##########......#
#......##########......#
#......................#
#......................#
#......................#
.......................#
.......................#
.......................#
.......................#
.......................#
.......................#
.......................#
########################
