MapSize 24 48
StartPos 3 3
########################
#......................#
#......................#
#......................#
#......................#
#......................#
#......................#
#......................#
#......................#
#......##########......#
#......##########......#
#......##########......#
#......##########......#
#......................#
#......................#
#......................#
#......................#
#......................#
#......................#
#......................#
#......................#
#......................#
#......................#
##########...###########
##########...###########
#......................#
#......................#
#......................#
#......................#
#......................#
#......................#
#......................#
#......................#
#......................#
#......................#
#......................#
#......................#
#......................#
#......................#
#......................#
#......................#
#......................#
#......................#
#......................#
#......................#
#......................#
#......................#
########################